20 20
7 7
0 0 0 0 0 0 0 0 0 0 0 0 0 0 0 0 0 0 0 0
0 0 0 0 0 0 0 0 0 0 0 0 0 0 0 0 0 0 0 0
0 0 0 0 0 0 0 0 0 0 0 0 0 0 0 0 0 0 0 0
0 0 0 0 0 0 0 0 0 0 0 0 0 0 0 0 0 0 0 0
0 0 0 0 0 0 0 0 0 0 0 0 0 0 0 0 0 0 0 0
0 0 0 0 0 0 0 2 2 2 2 2 2 0 0 0 0 0 0 0
0 0 0 0 0 0 2 2 2 2 2 2 2 2 0 0 0 0 0 0
0 0 0 0 0 2 2 2 2 3 2 2 4 2 2 0 0 0 0 0
0 0 0 0 0 2 2 1 0 0 0 2 2 2 2 0 0 0 0 0
0 0 0 0 0 2 2 0 0 0 0 2 2 2 2 0 0 0 0 0
0 0 0 0 0 2 2 0 0 0 0 2 4 2 2 0 0 0 0 0
0 0 0 0 0 3 2 2 2 2 2 2 2 2 2 0 0 0 0 0
0 0 0 0 0 2 2 2 2 2 2 2 2 2 2 0 0 0 0 0
0 0 0 0 0 0 2 2 3 2 2 3 2 2 0 0 0 0 0 0
0 0 0 0 0 0 0 2 2 3 2 2 2 0 0 0 0 0 0 0
0 0 0 0 0 0 0 0 0 0 0 0 0 0 0 0 0 0 0 0
0 0 0 0 0 0 0 0 0 0 0 0 0 0 0 0 0 0 0 0
0 0 0 0 0 0 0 0 0 0 0 0 0 0 0 0 0 0 0 0
0 0 0 0 0 0 0 0 0 0 0 0 0 0 0 0 0 0 0 0
0 0 0 0 0 0 0 0 0 0 0 0 0 0 0 0 0 0 0 0
